S.......#........
........#........
........#........
........#........
........#........
........#........
........#........
.................
................G
