#####################
#S........#.........#
#...................#
#.........#.........#
#.........#.........#
#####.#########.#####
#.........#.........#
#.........#.........#
#...................#
#.........#........G#
#####################
