S.#.#.#.#.#.#.#.#.#.#
.....................
#.#.#.#.#.#.#.#.#.#.#
.....................
#.#.#.#.#.#.#.#.#.#.#
.....................
#.#.#.#.#.#.#.#.#.#.#
.....................
#.#.#.#.#.#.#.#.#.#.#
.....................
#.#.#.#.#.#.#.#.#.#.G
