S..............
#############..
...............
..#############
...............
#############..
...............
..#############
..............G
